11111111111
1P100000001
10010000001
10001000001
1E00C100001
11111111111